ORION	ZT ORION
Xaser	ZT Xaser
bmw540	TPS Dee
?01	PM TSA
Remix	Benny L.
SeBo-G	Sebo
?02	BC Benny
Jos+the+Boss	Z30 Jos the Boss
?03	TPS Lemmi
RiGo	TPS RiGo
?08	Volker
?07	J.K.
?06	Saxo
?05	Omen
mich4	BC Mich4
Myxin	GFC Myxin
DarthPunisher	BC DarthPunisher
DreamBoy	BC Dreamboy
Pusher8x	Ice.Pusherx8x
Benji-Racer-	Ice.Benji
ichbins	BC derFLO
GnoMi	TPS GnoMi
EdnoV6	TW Edno
T-o-D+Zoom	TPS Michael H.
Mr.Woody	BC Ph.Spielbusch
Gonzo+GER	BC CarstenG.
spookey%28GER%29	HoR spooky
paXton	TPS paXton
bullrazor	BC ALIEN
DrChillum	TPS DrChillum
%28Rc%29Benjamin	BC Benjamin
Polaxis	BC Polaxis
Soref	Ice.Soref
Chrize	dSk Christoph
C4T-GER	GFC C4T GER
TechnoFan	SoC TechnoFan
Derfrager	BC DerFrager
Schnig	AGRT Snogger
Andy%28GER%29	IRT Andy GER
kDesser	Ice.KDesser
Alminator	TPS Alminator
Dee_Jay	FDC Djay
?10	FDC Anderson
clueso	TPS clueso
Lenaria	BC Lenaria
SiL3nT	mydead.silent
?09	DEC Maniac
Lumpi_x	dSk Holger
matruex	sTn MaTrUeX
weißer+++wolf	eXR Andre
Ethi	HoR Ethi
The+Hero	FDC Dennis
GWADanny	BC GWADanny
Cali+%28GER%29	CoRe C.Winkler
itsmebartman	ESPB istmebartman
paule2win	IRT Paule
meil	Ice.SirWinston
rtog+papafant	IRT Papafant
aimbottle	Ice.aimbottle
sergio5585	HFD Christoph
randy_momola	IRT Nanas
radium	Z30 Ra
florian+berndt	IRT ogc
%C6thelstan	HoR Ethi
splattael	Ice.splattael
rob4ger	Xcite Rob
sir+erich	Z30 SirErich
p.maishaupt	IRT 2slow4u
jan-ole	BC Jan-Ole
firestorm97	Z30 Jo
ikarus75	HoR Ikarus
muffin82	BC timo m.
maddin15	Xcite Maddin
liquidviper	BC Liquido
m4ver1ck	P.Kubinji
avalon580	DT AvALoN580
spezi-losae	R.Paerschke
denis240106	GFC Dn1ce
kiste	CoRe C.Kistner
cali+%28ger%29	CoRe C.Winkler
jacknight	Xcite Novy
dragon_reborn	Dragon Reborn
zerby	Xcite Zerby
screeper	HoR Screeper
moeykaner	GGC moexkaner
ragrez	HoR Ragrez
highmaster	FDC chriZ
wolfmacher	Xcite Wolf
rogeriii	Z30 RogerIII
harthahn	HoR harthahn
magoo	Z30 Magoo
bremsbert	Ice.Bremsbert
denis55	Denis55
spider76	Z30 Spider
flaming+moe	HoR Moe
marcoschaefer	Ice.Brainless
djmellow101	S.Nagel
xandul	Z30 xandul
fox+the+elk	HoR Fox
phoenixilooka	ev0 Marco
roscout	KR Eric
alphaone	FDC AlphaOne
spooky%28ger%29	HoR spooky
nselbmann	FDC Fragezeichen
el-bobo	Z30 el-bobo
twingo74	ZBP-Jan
cool_big_andy	RSM Andy
bdog	S.Jankowiak
_2000	M.Stahn
MaraxX_2000	M.Stahn
rolle1977	Ice.Mc Clane
viper34th	Z30 Viper
mikie	GCRD Mikie
cvws	Ice.CVWS
r3c3r	BC Amadee
c.schuht	HoR Schuhti
ghostdriver	S.Boeschen
ascona+b	eXR Ascona B
doubleplay	BC doubleplay
cwest	RSM CWest
maraxx	M.Stahn
lfsgo	KlaPeGo
wombats	Z30 Wombats
heizer	HoR HEIZER
klausadam	BC K.Adam
omen	R.Pfensig
carrick	Ice.Carrick
jueweb	HoR jueweb
rf-heinz	ZBP-HeinZ
micha	Ice.Micha
jagger123	Z30 Jagger
elwoodianer	FDC eLwood
madman1972	FDC Madman
joker+1971	HoR Joker
rokl	FDC Rokl
intruder81	M.Lueth
%5Bespb%5D	Rammstein89
mikey23	eXR Mikey23
dandy+dust	Z30 Dandy Dust
flaming+moe	HoR Moe
4poserdreed	A.Hoeft
ginsi	BC FireFist
-freak-	S.Wolf
s0ftware	Xcite R4id
zimmi	HoT Zimmi
lexxxxx	HFD Alexander
fiore	PLZ-Black
wei%DFer+++wolf	eXR Andre
onfire	S.Suckow
barrytrotter	MDD BarryT
s0ul	MDD S0ul
memoo	Memoo
ole1000	ESPB Olaf
hanfer	HoR hanfer
simon0015	spdo Simon K.
malcomax	PLZ-Norris
matzexx	Xcite M.Ecken
elchott	elchott
batscher	chris.swe
spannemann	ev0 P.Mante
schrauberherz	GCRD Cossi
%28%28%28skin-tester%29%29%29	SR Heiden
paddi4	CoRe P.Schuelter
soucy	soucy
b0rn	ev0 B.Schenke
mr.iron	HoR Iron
jogy22	JS Jogy
brynestorm	BiA BryneStorm
gpmp	GCRD GPMP
n.engelhardt	BiA Budges
markes	markes
horsepower	HoT Horsepower
madmaxii	HoR MadMaxII
fasthammer	1stBFS FH
super+hero	125eR Rotax
flair	ZBP-flair
zerfer	ZerFEr
bioforce	KIB BioForce
spieltrieb	end SpielTrieb
ronyx	SENNA
ollihannover	OMR OlliHann.
%5Bbia%5Dluder	RM.Bauer
jabba-ranks	ZBP.JabbaR
rippedxfuel	KIB RippedXFuel
sashgaming	ArTec
christopherpeichl	BC Razor
matlog	Xcite Matlog
mensafest	HoR Mensa
iron+prime	HoR pRiMe
ketek	ketek
feuerdrache	CoRe Feuerdrache
dpnr3	Tera.MF H.Arndt
-para-	GER.Flo
murdock1987	schippi
rubi_88	Xcite Rubi
roxsic	nP Rock
rudy+van+buren	ineX R.v.Buren
dc2	RSM K4ne
mardox	IRT MaRDoX
erinc	low 58sTyLe
el+barto	IRT El Barto
tobias+thomas	IRT Relax
phlipper	ev0 Phlipper
_chris_	RAPTOR Chris
fireb0llch	Xcite K.Egloff
m5-power	GCRD Coulti
majorchrille	R.Paerschke
madmech	BC MadMech
stefkanne	BC Stefan
sledgehammer	GM Sledge
maverick+23	Xcite C.Barnick
climbs	GRT Climbs
muhrle	RAPTOR Muhrle
hausmeister	GCRD Much
truster	1stBFA Truster
gunger40	RTSW ICE
vag	RAPTOR VaG
dislozierter	1stBFA dislo
intermediate07	ev0 RaRaRa
lfs-hero	Xcite Hero
mickimicki	1stBFA Micki
marc+zentis	eXR Marci
askaih	1stBFA Askaih
mikeb	pod.MikeB
m4sterg	RAPTOR masterg
jens_schreiber	BC Jens
fretsche	eXR Phil
ak-racing+206	RAPTOR Intre
preludeba4	3R Ronny L.
125er+g%FCnni	KC Guenni
gr%FCni	LR grüner
painster	ineX P.Ellis
nob2	RTSW NOB2
t1bby	eXR T1bbY
schw4rz	HORST23
bratwurst	F1RST M.Lehnert
tom+clance	MDD Tom Clance
tsxraven	RaVeN
niceguy	CoRe M.Blohm
sch3u3rm1lch	IRT ThomasP
jenny01	Z30 R.Barrichello
pludda	Pludda.Inferno
zzz68	Z30 Rossi
haitaur	BC haitaur
john_doe_leon	3R John Doe
mathi24	mathi24
big.h	Z30 Heinz
pierre+dole	BC P.Dole
flax	Ice.cHoiCeS
docbrown	FDC dOc
huy77	HoT huy
i_feel_hardcore	Xite Andy
kart-36	3id J.Holmes
texasltu	Klaidas
dennisf	BC Dennis
timo1992	ev0 RaRaRa
bash0r	squassel.Inferno
galy	Tera.MF g4Lyyy
banshee11	DRT A.Kausch
gaw%5Bger%5D	TeW GAW
radek44	Radek.Inferno
snake00	eXR Snake00
mg-na3	Blacky
albertlfs	eXR Smutje
vernichter	DRT H.Kausch
hapetutt+baker	1stBFA Baker
horschte	1stBFA horschte
amok_	RP B.Blust
dennis10	RP A.Doerfler
mrwolf	BC Aero
kimble64	PlanB Kimble
braxel	TeW Braxel
pusherx8x	Ice.Pusherx8x
%5Bfar%5Dd1gga	aTTaX D1ggA
n%21ghtm%40re	7Karat Niklas
kaiquebra	MR K.Piropo
deutschland2007	GenR Dom
marco84	gRd-calimarco
cueper	BC cooper
gassenheitzer	DR.Jackal
patrick+kopczinsky	BC Patrick
blast3r	Ice.DrSpeed
waldi88	SRT-Wasrun
zero-lotus	zGLotus
ingo21	Xcite Ingo21
eric89	Bk d0Nni
sandman90	No1 MarcelDB
powersocke	Power.Inferno
grmblfx	HoR Morphy V
dom87	BC dom
shortmaker	Shortmaker
bberger	SRTA bberger
schumi91	EM.schumi91
zettlah	ERR.DEBUGGER
lupusc	SRTA LupusC
schorch62	eXR Schorch
m+51352	Z30 Michael
maurizionaselli	M.Naselli
firemike15	CoRe M.Paluch
%21flip%21	SRT-Flip
svenso0n	ev0 S.Kresmer
%21tobi%21	SRT-Tobi
c0r3	IoD C0r3
knil	RM.kniL
jaypee	RAPTOR JayPee
holle	Holle
sebastianhh	eXR Origus
discriminator	BFVR DiDi
yoschifu	ev0 S.Kramer
beze1337	BC beze
crazyskypimp	ineX T.Iivonen
thavron	TSF.Thavron
proxtlin3r	OMR proxtlin3r
llexxon	OMR llexxon
bips1968	BFVR Bips
sharkness	TSF.GODComplex
baldi	RM.baldi
kysidion	K.Kettmann
trekkerfahrer	LLM C.Reetz
westlake	RM.Dietmar
claus+lehner	RTSW Claus	OMR llexxon
mariogo	mario
mad+max+74	400er David
nixda-power	TSF Bjoern R.
troy	troy
andro.	CoRe A.Pavars
e-z.basti	RAPTOR BasTi
alexio_82	PLZ-AleXio
zapphord	CR Eisbaer
bonetti	Bone
iceman220376	Maurizio P.
xone	RM.xone
dynamite+devil	BC D3vil
ziomek21	cq.ziomm
torsten+holzhey	HoR Totti
makao	cq.Makao
sodai	SRT-pan
asnl	cq.Meewosh
temporato	FRT temporato
mighty+pharao	FRT Migpha
gargus	cq.Gargi
drift-smoke	RTSW-Smoke
foqs	cq.foqs
guru_pl	cq.GuRu
daniel1992	D.Potthoff
max92	RAPTOR Max
checkout	M.Gunzelmann
n+i+k+i	TRR Zeus
flame+cze	S M.Kapal
carstenh	aTTaX KiLl3r	OMR llexxon
zyxel	PLZ-Pacans
przemek21061995	v Arco
dzban	cq.Dzban
pokiger	TSF Philipp N.
mumpen1991	Tera.MF Rroeoeben
scoot11	CRO scoot
b0nd	aTTaX b0nd
papax	just.papax
fuse5	CR Fuse
delis	delis
lombardi	PLZ-lomb
germanpio	pod.germanpio
nestoras7	TDRT K.Nestoras
leon5p	CRO leon5p
sid6.8	RM.SID6.8
aleex%21	RM.aleex
geheimrat	BC Geheimrat
pr3d4t0r	BC pr3d4t0r
nima	BC Nima
moffer	Salatoimik moffer moffer
fasteddy	FastEddy
erweem	RTSW ErWeem
tfalke55	HoR Falke
ercules	PLZ-Ercules
undertaker00	qeD
numbertwo	CRO Number
ergin	PlanB Ergin
berndithebig	BC Berndi
alfik_78	clubR-Alf
takfuji	ari
zopp	Z30 zopp
alex182	ev0 AleX
moonlord	BC Papifix
kneeless	Birni
nexus23	Z30 Oglarun
xsx	RS M.Kloc
t3ddy	ev0 H.Tries
emyn	CoRe Vale
strik3	FFR Strike
m+ekstr%F6m	EM.Eckstroem
-%3Dw%21ckeds%21ck%3D-	IoD WickedSick
capcom	TR H.Arnold
albers+fan	SR C.Thun
zagi	RM zAgi
hotmail	CR R.Hoiting
br%F6sel	IoD Bootzie
woody1967	Woody
iod+wulf	IoD Wulf
snowpunk	SGP Snowpunk
prototyp	ev0 G.Sarioez
gordon666	cq D.Gajda
msk	cq.msk
nachoo	Biscocho
denny12	R T.Koreny
%21dani%21	SRT-Dani
grunner	ev0 R.Buttler
audimasta	CoRe F.Enersen
udopea	Bransebear
ghostfight3r	eXeYn
madasa	TR R.Kaluza
carulin	Caru
be2k	EM.Marcel
f%21nal	Tera.MF flix
greybull+%5Bcha%5D	TEM Y.Laprevotte
seldon	818 A.Szarka
commandermas	EM.Commo
maxxenat55	Max M.
failezz	GenR Seb
achim+ennenbach	SSP A.Ennenbach
thedarkone	ReinhardG
igrsm	IoD grsM
joachim+politzer	SSP Jopo
neffets65	LGR Emil
domre2913	domre2913
dennis93	n LazeR
thomas+kroll	SSP T.Kroll
darknesspainf1	Joonas
peterules	SR Pete
masterboy19660815	TRR T.Ulrich
storm_cloud	SR Storm
chanoman315	TAM Chano
clarkparker	BC C.Parker
ukkojokkis	GenR Otto
lacko86	CoRe L.Kovacs
zvu	HoR S.Zingler
uborkab%E9la	P.Hocza
n3ox	NOX Ronald
luthiano	AMG Luthiano
the_wheelman	v N.Morvai
attila_91	A.Lazar
falconbridge	RG Falcon
shadow1901	T.Magyar
teppari	WCL T.Soini
drift8	Airwolf
jkat	WCL jkat
jimjupider	HoR F.Hinz
kamikadze20063	ST.Rydzu
mondbrot	Mondbrot
xnyle	CMR Xnyle
webflat	BC Webflat
ratman	OMR Ratman
knistling	CMR Knistling
ken+johansen	K.Johansen
gutholz	CMR Gutholz
gtornado	EM.Nico
kimi07	EM.kimi07
jonny5lebt	BC Mike
laicarleader	EM.shubi
sr59	Steffen
jsrk	WCL jsrk
marcisz	STO M.Zandmanis
julikobanditto	revers-29
tcsabee	T.Cs
skyline_tomy	SBP T.Csaki
trenchcoatninja	ADVO TrenchcoatN
elnoobio	GenR Aidan
eetu71	S M.Sipola
kid222	kid
rsto+lt	Rsto lt
slovakia+ring	roman
mvelikov	RG^M.Velikov
mousemanlv	GenR Mouseman
zupinx12	[WCL] Zupi
mbutcher	[TC-R] Pete
pik_d	sa|pik_d
piggy501	[TC-R] Nick
chaa	nr P. Rose
bossforce	TDR Boss
luckyluket	[TC-R] Luke
sz%E9kely	T.Székely
degats	[TC-R] Elmo
pmw	CMR pmw
sil3nt	eXR silent
howlinmad22	[TC-R] Howlin
thedottorrent	Dottorrent
mr.sing	EM.N.Heiden
ricsi0324	R.Szijártó
adnaneren1977	[GD]ADNAN™
matias+92	M.Isosomppi
n+gin	[WCL] A.Valta
knight_atack	CoRe Y.Martin
cuprum	Edgar
tigrgame	[GLOW] TigR
no_one	sa|super D
brave	brave
edek	DFH Edek
limited	Velocity
russianattack96	ICeleritas45
terga	GenR Terga
the+duke	NOX The Duke
smashmolth	Ardee
sjoblom	IRM | M.Sjoblom
typeracing	S K.Raudsepp
oliver+feistkorn	voliveR
arox123	J.Teien